Department,Town,YES,NO,NULL,TOTAL
AMAZONAS,EL ENCANTO,170,51,2,223
AMAZONAS,LA CHORRERA,300,62,3,365
AMAZONAS,LA PEDRERA,189,25,1,215
AMAZONAS,LA VICTORIA,4,1,0,5
AMAZONAS,LETICIA,4403,4463,84,8950
AMAZONAS,MIRITI PARANA,89,7,0,96
AMAZONAS,PUERTO ALEGRIA,52,5,1,58
AMAZONAS,PUERTO ARICA,97,22,0,119
AMAZONAS,PUERTO NARIÃO,830,274,17,1121
AMAZONAS,PUERTO SANTANDER,125,16,2,143
AMAZONAS,TARAPACA,265,68,4,337
ANTIOQUIA,ABEJORRAL,1296,2105,52,3453
ANTIOQUIA,ABRIAQUI,213,332,13,558
ANTIOQUIA,ALEJANDRIA,966,696,22,1684
ANTIOQUIA,AMAGA,2084,4139,94,6317
ANTIOQUIA,AMALFI,1310,2304,72,3686
ANTIOQUIA,ANDES,3193,5729,93,9015
ANTIOQUIA,ANGELOPOLIS,553,1004,23,1580
ANTIOQUIA,ANGOSTURA,705,1089,84,1878
ANTIOQUIA,ANORI,1764,953,40,2757
ANTIOQUIA,ANTIOQUIA,2041,3300,102,5443
ANTIOQUIA,ANZA,363,740,16,1119
ANTIOQUIA,APARTADO,14195,12936,478,27609
ANTIOQUIA,ARBOLETES,3691,1937,57,5685
ANTIOQUIA,ARGELIA,650,1351,23,2024
ANTIOQUIA,ARMENIA,301,676,26,1003
ANTIOQUIA,BARBOSA,4200,8666,277,13143
ANTIOQUIA,BELLO,43642,76122,1577,121341
ANTIOQUIA,BELMIRA,687,897,17,1601
ANTIOQUIA,BETANIA,466,1110,22,1598
ANTIOQUIA,BETULIA,1005,1919,49,2973
ANTIOQUIA,BOLIVAR,1644,3875,60,5579
ANTIOQUIA,BRICEÃO,1367,604,45,2016
ANTIOQUIA,BURITICA,474,890,20,1384
ANTIOQUIA,CACERES,2506,1358,83,3947
ANTIOQUIA,CAICEDO,593,921,43,1557
ANTIOQUIA,CALDAS,9292,16149,397,25838
ANTIOQUIA,CAMPAMENTO,619,604,41,1264
ANTIOQUIA,CAÃASGORDAS,1911,2739,121,4771
ANTIOQUIA,CARACOLI,578,593,12,1183
ANTIOQUIA,CARAMANTA,568,790,26,1384
ANTIOQUIA,CAREPA,5327,6057,190,11574
ANTIOQUIA,CARMEN DE VIBORAL,5528,10787,272,16587
ANTIOQUIA,CAROLINA,464,641,23,1128
ANTIOQUIA,CAUCASIA,8801,11495,368,20664
ANTIOQUIA,CHIGORODO,6322,5745,187,12254
ANTIOQUIA,CISNEROS,1084,1837,63,2984
ANTIOQUIA,COCORNA,1647,3006,81,4734
ANTIOQUIA,CONCEPCION,572,931,27,1530
ANTIOQUIA,CONCORDIA,998,2081,50,3129
ANTIOQUIA,COPACABANA,9535,15052,369,24956
ANTIOQUIA,DABEIBA,2971,1622,99,4692
ANTIOQUIA,DON MATIAS,1371,3898,71,5340
ANTIOQUIA,EBEJICO,967,1788,32,2787
ANTIOQUIA,EL BAGRE,3167,4056,156,7379
ANTIOQUIA,ENTRERRIOS,868,1766,30,2664
ANTIOQUIA,ENVIGADO,37800,67255,1061,106116
ANTIOQUIA,FREDONIA,1703,3064,64,4831
ANTIOQUIA,FRONTINO,2148,1744,78,3970
ANTIOQUIA,GIRALDO,666,557,17,1240
ANTIOQUIA,GIRARDOTA,6088,10680,277,17045
ANTIOQUIA,GOMEZ PLATA,772,1328,61,2161
ANTIOQUIA,GRANADA,1382,2120,53,3555
ANTIOQUIA,GUADALUPE,714,587,47,1348
ANTIOQUIA,GUARNE,3870,10604,214,14688
ANTIOQUIA,GUATAPE,1232,1966,37,3235
ANTIOQUIA,HELICONIA,632,795,29,1456
ANTIOQUIA,HISPANIA,459,654,11,1124
ANTIOQUIA,ITAGUI,35166,59627,1344,96137
ANTIOQUIA,ITUANGO,2706,1196,116,4018
ANTIOQUIA,JARDIN,1620,2884,44,4548
ANTIOQUIA,JERICO,957,2341,39,3337
ANTIOQUIA,LA CEJA,6715,15589,325,22629
ANTIOQUIA,LA ESTRELLA,6725,11716,194,18635
ANTIOQUIA,LA PINTADA,1017,1389,31,2437
ANTIOQUIA,LA UNION,2551,4782,136,7469
ANTIOQUIA,LIBORINA,933,1674,40,2647
ANTIOQUIA,MACEO,777,1065,26,1868
ANTIOQUIA,MARINILLA,5481,11993,190,17664
ANTIOQUIA,MEDELLIN,253548,431173,6754,691475
ANTIOQUIA,MONTEBELLO,953,776,35,1764
ANTIOQUIA,MURINDO,1073,44,14,1131
ANTIOQUIA,MUTATA,1846,1016,49,2911
ANTIOQUIA,NARIÃO,786,1626,31,2443
ANTIOQUIA,NECHI,1937,1799,57,3793
ANTIOQUIA,NECOCLI,4359,2860,155,7374
ANTIOQUIA,OLAYA,273,449,7,729
ANTIOQUIA,PEÃOL,2032,3265,55,5352
ANTIOQUIA,PEQUE,1632,608,43,2283
ANTIOQUIA,PUEBLORRICO,593,1138,24,1755
ANTIOQUIA,PUERTO BERRIO,2780,6046,116,8942
ANTIOQUIA,PUERTO NARE-LA MAGDALENA,2281,1600,55,3936
ANTIOQUIA,PUERTO TRIUNFO,1007,2823,42,3872
ANTIOQUIA,REMEDIOS,1186,2229,126,3541
ANTIOQUIA,RETIRO,2145,4703,58,6906
ANTIOQUIA,RIONEGRO,14361,32596,637,47594
ANTIOQUIA,SABANALARGA,778,1501,41,2320
ANTIOQUIA,SABANETA,9955,16903,285,27143
ANTIOQUIA,SALGAR,782,1621,24,2427
ANTIOQUIA,SAN ANDRES,706,864,65,1635
ANTIOQUIA,SAN CARLOS,2390,2697,95,5182
ANTIOQUIA,SAN FRANCISCO,660,901,26,1587
ANTIOQUIA,SAN JERONIMO,1260,2135,41,3436
ANTIOQUIA,SAN JOSE DE LA MONTAÃA,363,621,23,1007
ANTIOQUIA,SAN JUAN DE URABA,2677,1365,33,4075
ANTIOQUIA,SAN LUIS,890,2681,36,3607
ANTIOQUIA,SAN PEDRO,1841,5334,106,7281
ANTIOQUIA,SAN PEDRO DE URABA,2060,1982,62,4104
ANTIOQUIA,SAN RAFAEL,1457,2295,258,4010
ANTIOQUIA,SAN ROQUE,1786,2548,79,4413
ANTIOQUIA,SAN VICENTE,1642,4238,80,5960
ANTIOQUIA,SANTA BARBARA,2101,3788,107,5996
ANTIOQUIA,SANTA ROSA DE OSOS,2984,6927,279,10190
ANTIOQUIA,SANTO DOMINGO,1085,1681,107,2873
ANTIOQUIA,SANTUARIO,3329,9020,150,12499
ANTIOQUIA,SEGOVIA,1516,3073,68,4657
ANTIOQUIA,SONSON,2319,6550,266,9135
ANTIOQUIA,SOPETRAN,1875,2266,60,4201
ANTIOQUIA,TAMESIS,1579,2889,52,4520
ANTIOQUIA,TARAZA,3477,2311,110,5898
ANTIOQUIA,TARSO,503,691,14,1208
ANTIOQUIA,TITIRIBI,742,1362,39,2143
ANTIOQUIA,TOLEDO,798,507,63,1368
ANTIOQUIA,TURBO,11378,8887,371,20636
ANTIOQUIA,URAMITA,951,813,37,1801
ANTIOQUIA,URRAO,2644,2959,138,5741
ANTIOQUIA,VALDIVIA,1072,1069,57,2198
ANTIOQUIA,VALPARAISO,597,893,22,1512
ANTIOQUIA,VEGACHI,503,1268,22,1793
ANTIOQUIA,VENECIA,1097,1767,26,2890
ANTIOQUIA,VIGIA DEL FUERTE,2079,86,13,2178
ANTIOQUIA,YALI,437,692,6,1135
ANTIOQUIA,YARUMAL,2941,6091,187,9219
ANTIOQUIA,YOLOMBO,1344,2055,57,3456
ANTIOQUIA,YONDO-CASABE,2376,2810,128,5314
ANTIOQUIA,ZARAGOZA,1672,1726,88,3486
ARAUCA,ARAUCA,8159,15191,447,23797
ARAUCA,ARAUQUITA,7440,2289,234,9963
ARAUCA,CRAVO NORTE,424,630,38,1092
ARAUCA,FORTUL,2338,1063,187,3588
ARAUCA,PUERTO RONDON,428,666,19,1113
ARAUCA,SARAVENA,4457,5168,335,9960
ARAUCA,TAME,5407,5267,263,10937
ATLANTICO,BARANOA,8936,3416,58,12410
ATLANTICO,BARRANQUILLA,146039,108178,1111,255328
ATLANTICO,CAMPO DE LA CRUZ,1728,1057,14,2799
ATLANTICO,CANDELARIA,2078,906,25,3009
ATLANTICO,GALAPA,5186,3176,74,8436
ATLANTICO,JUAN DE ACOSTA,2389,1082,19,3490
ATLANTICO,LURUACO,2265,1246,25,3536
ATLANTICO,MALAMBO,8810,6908,94,15812
ATLANTICO,MANATI,1660,317,10,1987
ATLANTICO,PALMAR DE VARELA,2871,1117,22,4010
ATLANTICO,PIOJO,1118,391,15,1524
ATLANTICO,POLONUEVO,2746,639,29,3414
ATLANTICO,PONEDERA,2445,1421,20,3886
ATLANTICO,PUERTO COLOMBIA,5701,3565,38,9304
ATLANTICO,REPELON,3325,829,24,4178
ATLANTICO,SABANAGRANDE,3251,1835,29,5115
ATLANTICO,SABANALARGA,12851,4663,142,17656
ATLANTICO,SANTA LUCIA,1467,481,18,1966
ATLANTICO,SANTO TOMAS,4088,1614,24,5726
ATLANTICO,SOLEDAD,33765,23487,307,57559
ATLANTICO,SUAN,1837,585,3,2425
ATLANTICO,TUBARA,1888,898,16,2802
ATLANTICO,USIACURI,1677,489,15,2181
BOGOTA D.C.,BOGOTA. D.C.,1423612,1114933,25213,2563758
BOLIVAR,ACHI,4307,1874,87,6268
BOLIVAR,ALTOS DEL ROSARIO,786,601,15,1402
BOLIVAR,ARENAL,1690,229,23,1942
BOLIVAR,ARJONA,6030,3642,63,9735
BOLIVAR,ARROYO HONDO,1118,363,7,1488
BOLIVAR,BARRANCO DE LOBA,1465,1284,22,2771
BOLIVAR,CALAMAR,2140,1490,37,3667
BOLIVAR,CANTAGALLO,1878,732,44,2654
BOLIVAR,CARTAGENA,81500,64735,518,146753
BOLIVAR,CICUCO,2082,856,21,2959
BOLIVAR,CLEMENCIA,1146,590,17,1753
BOLIVAR,CORDOBA,3612,1001,43,4656
BOLIVAR,EL CARMEN DE BOLIVAR,8287,7290,216,15793
BOLIVAR,EL GUAMO,1578,405,11,1994
BOLIVAR,EL PEÃON,911,574,15,1500
BOLIVAR,HATILLO DE LOBA,1322,1285,25,2632
BOLIVAR,MAGANGUE,16478,9966,261,26705
BOLIVAR,MAHATES,2819,1222,32,4073
BOLIVAR,MARGARITA,1361,919,13,2293
BOLIVAR,MARIA LA BAJA,7009,1761,73,8843
BOLIVAR,MOMPOS,5198,3036,68,8302
BOLIVAR,MONTECRISTO,1652,395,17,2064
BOLIVAR,MORALES,1936,2206,39,4181
BOLIVAR,NOROSI,969,177,14,1160
BOLIVAR,PINILLOS,2973,1885,41,4899
BOLIVAR,REGIDOR,1092,323,18,1433
BOLIVAR,RIOVIEJO,1488,639,30,2157
BOLIVAR,SAN CRISTOBAL,1630,249,8,1887
BOLIVAR,SAN ESTANISLAO,1900,869,19,2788
BOLIVAR,SAN FERNANDO,1949,428,15,2392
BOLIVAR,SAN JACINTO,3736,2477,62,6275
BOLIVAR,SAN JACINTO DEL CAUCA,1389,612,18,2019
BOLIVAR,SAN JUAN NEPOMUCENO,5134,3287,111,8532
BOLIVAR,SAN MARTIN DE LOBA,1943,856,22,2821
BOLIVAR,SAN PABLO,2802,2940,94,5836
BOLIVAR,SANTA CATALINA,1759,553,119,2431
BOLIVAR,SANTA ROSA,1129,609,24,1762
BOLIVAR,SANTA ROSA DEL SUR,2648,4421,112,7181
BOLIVAR,SIMITI,1753,1783,73,3609
BOLIVAR,SOPLAVIENTO,1888,324,20,2232
BOLIVAR,TALAIGUA NUEVO,1870,1045,16,2931
BOLIVAR,TIQUISIO (PTO. RICO),1686,1366,22,3074
BOLIVAR,TURBACO,5927,3957,41,9925
BOLIVAR,TURBANA,1728,781,17,2526
BOLIVAR,VILLANUEVA,1181,763,14,1958
BOLIVAR,ZAMBRANO,3140,507,46,3693
BOYACA,ALMEIDA,348,327,11,686
BOYACA,AQUITANIA (PUEBLOVIEJO),1208,2985,65,4258
BOYACA,ARCABUCO,773,882,54,1709
BOYACA,BELEN,1150,1344,81,2575
BOYACA,BERBEO,387,181,15,583
BOYACA,BETEITIVA,407,252,19,678
BOYACA,BOAVITA,798,1002,40,1840
BOYACA,BOYACA,601,432,24,1057
BOYACA,BRICEÃO,471,282,7,760
BOYACA,BUENAVISTA,616,790,29,1435
BOYACA,BUSBANZA,174,183,7,364
BOYACA,CALDAS,651,453,24,1128
BOYACA,CAMPOHERMOSO,507,432,23,962
BOYACA,CERINZA,961,595,54,1610
BOYACA,CHINAVITA,421,497,17,935
BOYACA,CHIQUINQUIRA,8110,8619,303,17032
BOYACA,CHIQUIZA,537,330,27,894
BOYACA,CHISCAS,672,658,40,1370
BOYACA,CHITA,861,1294,75,2230
BOYACA,CHITARAQUE,644,962,19,1625
BOYACA,CHIVATA,477,439,7,923
BOYACA,CHIVOR,260,378,8,646
BOYACA,CIENEGA,543,655,16,1214
BOYACA,COMBITA,2081,1452,86,3619
BOYACA,COPER,779,521,19,1319
BOYACA,CORRALES,408,511,22,941
BOYACA,COVARACHIA,394,626,16,1036
BOYACA,CUBARA,781,597,68,1446
BOYACA,CUCAITA,683,543,30,1256
BOYACA,CUITIVA,269,363,19,651
BOYACA,DUITAMA,19535,20787,770,41092
BOYACA,EL COCUY,374,830,48,1252
BOYACA,EL ESPINO,339,627,20,986
BOYACA,FIRAVITOBA,1317,758,37,2112
BOYACA,FLORESTA,527,799,20,1346
BOYACA,GACHANTIVA,621,678,24,1323
BOYACA,GAMEZA,621,825,23,1469
BOYACA,GARAGOA,2534,2485,119,5138
BOYACA,GUACAMAYAS,122,479,19,620
BOYACA,GUATEQUE,1718,1599,80,3397
BOYACA,GUAYATA,861,633,22,1516
BOYACA,GUICAN,556,592,42,1190
BOYACA,IZA,367,465,13,845
BOYACA,JENESANO,1031,584,33,1648
BOYACA,JERICO,359,570,23,952
BOYACA,LA CAPILLA,525,493,28,1046
BOYACA,LA UVITA,287,611,19,917
BOYACA,LA VICTORIA,417,136,9,562
BOYACA,LABRANZAGRANDE,444,529,17,990
BOYACA,MACANAL,464,728,24,1216
BOYACA,MARIPI,1371,459,25,1855
BOYACA,MIRAFLORES,2330,1233,81,3644
BOYACA,MONGUA,397,1258,25,1680
BOYACA,MONGUI,530,870,29,1429
BOYACA,MONIQUIRA,3257,3016,162,6435
BOYACA,MOTAVITA,955,836,41,1832
BOYACA,MUZO,858,1470,55,2383
BOYACA,NOBSA,2835,2809,86,5730
BOYACA,NUEVO COLON,1107,624,46,1777
BOYACA,OICATA,605,492,30,1127
BOYACA,OTANCHE,1021,1297,28,2346
BOYACA,PACHAVITA,370,374,15,759
BOYACA,PAEZ,558,613,43,1214
BOYACA,PAIPA,6187,4866,200,11253
BOYACA,PAJARITO,234,399,9,642
BOYACA,PANQUEBA,285,335,15,635
BOYACA,PAUNA,1521,802,41,2364
BOYACA,PAYA,320,383,26,729
BOYACA,PAZ DE RIO,1119,566,38,1723
BOYACA,PESCA,710,1061,33,1804
BOYACA,PISBA,195,256,3,454
BOYACA,PUERTO BOYACA,4270,9611,339,14220
BOYACA,QUIPAMA,637,1066,32,1735
BOYACA,RAMIRIQUI,1466,1267,34,2767
BOYACA,RAQUIRA,815,851,44,1710
BOYACA,RONDON,469,426,17,912
BOYACA,SABOYA,2246,1250,112,3608
BOYACA,SACHICA,702,624,13,1339
BOYACA,SAMACA,2343,2340,130,4813
BOYACA,SAN EDUARDO,434,245,22,701
BOYACA,SAN JOSE DE PARE,946,844,20,1810
BOYACA,SAN LUIS DE GACENO,628,1111,22,1761
BOYACA,SAN MATEO,368,720,30,1118
BOYACA,SAN MIGUEL DE SEMA,513,550,21,1084
BOYACA,SAN PABLO DE BORBUR,584,1246,29,1859
BOYACA,SANTA MARIA,433,656,30,1119
BOYACA,SANTA ROSA DE VITERBO,1553,2073,72,3698
BOYACA,SANTA SOFIA,648,399,21,1068
BOYACA,SANTANA,1106,1034,34,2174
BOYACA,SATIVANORTE,373,362,23,758
BOYACA,SATIVASUR,197,174,4,375
BOYACA,SIACHOQUE,778,1453,54,2285
BOYACA,SOATA,1461,1989,56,3506
BOYACA,SOCHA,1138,1160,64,2362
BOYACA,SOCOTA,791,1214,60,2065
BOYACA,SOGAMOSO,20261,20865,700,41826
BOYACA,SOMONDOCO,529,344,14,887
BOYACA,SORA,686,459,22,1167
BOYACA,SORACA,740,1489,24,2253
BOYACA,SOTAQUIRA,1039,978,39,2056
BOYACA,SUSACON,701,410,36,1147
BOYACA,SUTAMARCHAN,1132,931,38,2101
BOYACA,SUTATENZA,612,662,30,1304
BOYACA,TASCO,913,641,37,1591
BOYACA,TENZA,1028,592,26,1646
BOYACA,TIBANA,1312,740,57,2109
BOYACA,TIBASOSA,1842,1685,75,3602
BOYACA,TINJACA,632,505,20,1157
BOYACA,TIPACOQUE,557,520,29,1106
BOYACA,TOCA,1107,1168,40,2315
BOYACA,TOGUI,516,410,22,948
BOYACA,TOPAGA,552,789,19,1360
BOYACA,TOTA,318,590,25,933
BOYACA,TUNJA,32780,25112,1003,58895
BOYACA,TUNUNGUA,461,181,9,651
BOYACA,TURMEQUE,1161,568,41,1770
BOYACA,TUTA,1536,1497,57,3090
BOYACA,TUTAZA,492,412,29,933
BOYACA,UMBITA,980,1224,47,2251
BOYACA,VENTAQUEMADA,1566,1689,81,3336
BOYACA,VILLA DE LEIVA,2479,2307,66,4852
BOYACA,VIRACACHA,343,452,16,811
BOYACA,ZETAQUIRA,910,473,15,1398
CALDAS,AGUADAS,1961,4766,174,6901
CALDAS,ANSERMA,3356,7430,270,11056
CALDAS,ARANZAZU,1573,2409,123,4105
CALDAS,BELALCAZAR,1514,2105,52,3671
CALDAS,CHINCHINA,6185,10543,315,17043
CALDAS,FILADELFIA,1365,1783,62,3210
CALDAS,LA DORADA,6908,13558,545,21011
CALDAS,LA MERCED,866,1108,50,2024
CALDAS,MANIZALES,74140,76961,2505,153606
CALDAS,MANZANARES,1773,3146,91,5010
CALDAS,MARMATO,514,1133,41,1688
CALDAS,MARQUETALIA,1452,2427,93,3972
CALDAS,MARULANDA,387,391,32,810
CALDAS,NEIRA,2283,4191,168,6642
CALDAS,NORCASIA,906,1179,51,2136
CALDAS,PACORA,1548,2727,76,4351
CALDAS,PALESTINA,1867,2513,51,4431
CALDAS,PENSILVANIA,1880,3959,191,6030
CALDAS,RIOSUCIO,6070,8402,399,14871
CALDAS,RISARALDA,959,2021,49,3029
CALDAS,SALAMINA,2096,3021,86,5203
CALDAS,SAMANA,2814,3513,209,6536
CALDAS,SAN JOSE,623,817,30,1470
CALDAS,SUPIA,2408,4985,349,7742
CALDAS,VICTORIA,1249,1735,51,3035
CALDAS,VILLAMARIA,7470,9806,330,17606
CALDAS,VITERBO,1373,3737,56,5166
CAQUETA,ALBANIA,445,842,22,1309
CAQUETA,BELEN DE LOS ANDAQUIES,1001,1504,59,2564
CAQUETA,CARTAGENA DEL CHAIRA,3530,1256,81,4867
CAQUETA,CURILLO,729,1052,55,1836
CAQUETA,EL DONCELLO,1593,2511,89,4193
CAQUETA,EL PAUJIL,1157,1439,52,2648
CAQUETA,FLORENCIA,14803,23593,421,38817
CAQUETA,LA MONTAÃITA,2295,797,23,3115
CAQUETA,MILAN,750,590,20,1360
CAQUETA,MORELIA,387,731,16,1134
CAQUETA,PUERTO RICO,2643,2645,104,5392
CAQUETA,SAN JOSE DEL FRAGUA,1116,1699,55,2870
CAQUETA,SAN VICENTE DEL CAGUAN,6034,3554,111,9699
CAQUETA,SOLANO,1506,460,20,1986
CAQUETA,SOLITA,484,804,26,1314
CAQUETA,VALPARAISO,724,805,60,1589
CASANARE,AGUAZUL,4123,9666,599,14388
CASANARE,CHAMEZA,663,271,25,959
CASANARE,HATO COROZAL,591,2133,61,2785
CASANARE,LA SALINA,391,51,11,453
CASANARE,MANI,1459,3265,86,4810
CASANARE,MONTERREY,1639,3998,87,5724
CASANARE,NUNCHIA,579,2272,67,2918
CASANARE,OROCUE,1182,1800,61,3043
CASANARE,PAZ DE ARIPORO (MORENO),2243,7379,210,9832
CASANARE,PORE,662,2684,91,3437
CASANARE,RECETOR,337,305,43,685
CASANARE,SABANALARGA,680,664,30,1374
CASANARE,SACAMA,563,97,77,737
CASANARE,SAN LUIS DE PALENQUE,548,1988,52,2588
CASANARE,TAMARA,528,1350,42,1920
CASANARE,TAURAMENA,2209,6037,139,8385
CASANARE,TRINIDAD,735,2966,87,3788
CASANARE,VILLANUEVA,2425,5625,173,8223
CASANARE,YOPAL,14561,36503,858,51922
CAUCA,ALMAGUER,2874,570,169,3613
CAUCA,ARGELIA,5807,751,175,6733
CAUCA,BALBOA,4425,731,126,5282
CAUCA,BOLIVAR,5234,2772,286,8292
CAUCA,BUENOS AIRES,4594,1773,188,6555
CAUCA,CAJIBIO,4922,2002,138,7062
CAUCA,CALDONO,6792,1715,267,8774
CAUCA,CALOTO,5875,2183,166,8224
CAUCA,CORINTO,5669,2520,187,8376
CAUCA,EL TAMBO,6595,4616,359,11570
CAUCA,FLORENCIA,1530,520,64,2114
CAUCA,GUACHENE,4160,1663,202,6025
CAUCA,GUAPI,5596,415,78,6089
CAUCA,INZA,3318,1177,74,4569
CAUCA,JAMBALO,3270,520,89,3879
CAUCA,LA SIERRA,1714,1109,63,2886
CAUCA,LA VEGA,3840,1121,128,5089
CAUCA,LOPEZ (MICAY),3980,265,12,4257
CAUCA,MERCADERES,3135,960,77,4172
CAUCA,MIRANDA,5933,3379,166,9478
CAUCA,MORALES,3764,2412,225,6401
CAUCA,PADILLA,2258,752,104,3114
CAUCA,PAEZ (BELALCAZAR),4692,1801,154,6647
CAUCA,PATIA (EL BORDO),5770,2233,112,8115
CAUCA,PIAMONTE,996,492,31,1519
CAUCA,PIENDAMO,4840,4240,149,9229
CAUCA,POPAYAN,55296,38628,1229,95153
CAUCA,PUERTO TEJADA,8482,4123,334,12939
CAUCA,PURACE (COCONUCO),1458,822,54,2334
CAUCA,ROSAS,1794,1211,90,3095
CAUCA,SAN SEBASTIAN,1991,530,70,2591
CAUCA,SANTA ROSA,787,421,32,1240
CAUCA,SANTANDER DE QUILICHAO,16723,12224,569,29516
CAUCA,SILVIA,5792,1804,193,7789
CAUCA,SOTARA (PAISPAMBA),2010,927,83,3020
CAUCA,SUAREZ,3890,1912,215,6017
CAUCA,SUCRE,1418,304,31,1753
CAUCA,TIMBIO,5047,4057,191,9295
CAUCA,TIMBIQUI,5885,370,64,6319
CAUCA,TORIBIO,6535,1171,165,7871
CAUCA,TOTORO,2615,884,57,3556
CAUCA,VILLA RICA,3913,1696,206,5815
CESAR,AGUACHICA,8179,18389,430,26998
CESAR,AGUSTIN CODAZZI,6261,6681,163,13105
CESAR,ASTREA,2004,1793,40,3837
CESAR,BECERRIL,2753,1787,58,4598
CESAR,BOSCONIA,4979,3593,109,8681
CESAR,CHIMICHAGUA,3327,2834,95,6256
CESAR,CHIRIGUANA,3850,2666,97,6613
CESAR,CURUMANI,4286,2952,109,7347
CESAR,EL COPEY,3761,2061,77,5899
CESAR,EL PASO,4073,2292,68,6433
CESAR,GAMARRA,1609,1777,26,3412
CESAR,GONZALEZ,608,560,44,1212
CESAR,LA GLORIA,1881,1776,54,3711
CESAR,LA JAGUA DE IBIRICO,5096,4321,219,9636
CESAR,LA PAZ,3528,2583,65,6176
CESAR,MANAURE BALCON DEL CESAR (MANA,1913,1206,46,3165
CESAR,PAILITAS,2874,1943,149,4966
CESAR,PELAYA,2222,2410,106,4738
CESAR,PUEBLO BELLO,1706,785,37,2528
CESAR,RIO DE ORO,1605,2695,63,4363
CESAR,SAN ALBERTO,2496,4100,99,6695
CESAR,SAN DIEGO,3003,1884,75,4962
CESAR,SAN MARTIN,1934,3623,111,5668
CESAR,TAMALAMEQUE,1859,892,60,2811
CESAR,VALLEDUPAR,44788,41843,898,87529
CHOCO,ACANDI,1568,485,19,2072
CHOCO,ALTO BAUDO (PIE DE PATO),2942,234,19,3195
CHOCO,ATRATO (YUTO),2080,504,60,2644
CHOCO,BAGADO,2264,196,46,2506
CHOCO,BAHIA SOLANO (MUTIS),1917,389,20,2326
CHOCO,BAJO BAUDO (PIZARRO),2741,233,21,2995
CHOCO,BOJAYA (BELLAVISTA),1978,87,15,2080
CHOCO,CARMEN DEL DARIEN,1290,58,8,1356
CHOCO,CERTEGUI,1238,382,87,1707
CHOCO,CONDOTO,2296,863,140,3299
CHOCO,EL CANTON DEL SAN PABLO (MAN.,916,307,36,1259
CHOCO,EL CARMEN,1033,799,46,1878
CHOCO,EL LITORAL DEL SAN JUAN,2508,135,12,2655
CHOCO,ISTMINA,3990,1679,155,5824
CHOCO,JURADO,580,144,7,731
CHOCO,LLORO,2128,435,63,2626
CHOCO,MEDIO ATRATO (BETE),2145,93,8,2246
CHOCO,MEDIO BAUDO (PUERTO MELUK),2561,187,23,2771
CHOCO,MEDIO SAN JUAN,2580,411,54,3045
CHOCO,NOVITA,1212,423,74,1709
CHOCO,NUQUI,1416,103,12,1531
CHOCO,QUIBDO,20260,7159,795,28214
CHOCO,RIO IRO,1185,115,27,1327
CHOCO,RIO QUITO (PAIMADO),1965,578,34,2577
CHOCO,RIOSUCIO,3462,345,36,3843
CHOCO,SAN JOSE DEL PALMAR,724,308,47,1079
CHOCO,SIPI,618,88,26,732
CHOCO,TADO,2830,1238,157,4225
CHOCO,UNGUIA,1426,736,16,2178
CHOCO,UNION PANAMERICANA (LAS ANIMAS,1404,381,41,1826
CONSULADOS,ALEMANIA,488,75,1,564
CONSULADOS,ANTIGUA Y BARBUDA,0,0,0,0
CONSULADOS,ARGENTINA,1166,226,2,1394
CONSULADOS,ARUBA,228,426,1,655
CONSULADOS,AUSTRALIA,695,280,0,975
CONSULADOS,AUSTRIA,139,29,0,168
CONSULADOS,BELGICA,314,71,0,385
CONSULADOS,BOLIVIA,67,60,0,127
CONSULADOS,BRASIL,388,86,2,476
CONSULADOS,CANADA,2717,1559,6,4282
CONSULADOS,CHILE,879,421,1,1301
CONSULADOS,CHINA REPUBLICA POPULAR,68,10,0,78
CONSULADOS,CHIPRE,13,10,1,24
CONSULADOS,COREA DEL SUR,20,2,0,22
CONSULADOS,COSTA RICA,825,832,4,1661
CONSULADOS,CUBA,16,1,0,17
CONSULADOS,CURAZAO,89,142,2,233
CONSULADOS,DINAMARCA,28,1,0,29
CONSULADOS,ECUADOR,1686,991,13,2690
CONSULADOS,EGIPTO,14,2,0,16
CONSULADOS,EL SALVADOR,66,67,0,133
CONSULADOS,EMIRATOS ARABES UNIDOS,63,217,1,281
CONSULADOS,ESPAÃA,4891,2235,4,7130
CONSULADOS,ESTADOS UNIDOS,12816,21347,33,34196
CONSULADOS,FILIPINAS,12,4,0,16
CONSULADOS,FINLANDIA,33,6,0,39
CONSULADOS,FRANCIA,1498,317,0,1815
CONSULADOS,GHANA,5,0,0,5
CONSULADOS,GRECIA,19,4,0,23
CONSULADOS,GUATEMALA,109,106,0,215
CONSULADOS,HOLANDA,233,68,0,301
CONSULADOS,HONDURAS,34,27,0,61
CONSULADOS,INDIA,14,0,0,14
CONSULADOS,INDONESIA,47,9,0,56
CONSULADOS,INGLATERRA,1159,532,2,1693
CONSULADOS,IRLANDA,33,16,0,49
CONSULADOS,ISRAEL,39,22,1,62
CONSULADOS,ITALIA,321,107,2,430
CONSULADOS,JAMAICA,14,18,0,32
CONSULADOS,JAPON,79,33,0,112
CONSULADOS,KENIA,13,2,0,15
CONSULADOS,LIBANO,34,12,0,46
CONSULADOS,MALASIA,13,7,0,20
CONSULADOS,MARRUECOS,6,0,0,6
CONSULADOS,MEXICO,742,337,0,1079
CONSULADOS,NICARAGUA,48,13,0,61
CONSULADOS,NORUEGA,26,1,0,27
CONSULADOS,NUEVA ZELANDIA,59,24,0,83
CONSULADOS,PANAMA,704,783,3,1490
CONSULADOS,PARAGUAY,34,36,0,70
CONSULADOS,PERU,449,239,1,689
CONSULADOS,POLONIA,21,5,0,26
CONSULADOS,PORTUGAL,58,15,0,73
CONSULADOS,PUERTO RICO,148,100,0,248
CONSULADOS,REPUBLICA DOMINICANA,294,218,0,512
CONSULADOS,RUSIA,31,3,0,34
CONSULADOS,SUDAFRICA,41,21,1,63
CONSULADOS,SUECIA,216,57,0,273
CONSULADOS,SUIZA,514,142,0,656
CONSULADOS,TAILANDIA,13,2,0,15
CONSULADOS,TRINIDAD Y TOBAGO,13,11,0,24
CONSULADOS,TURQUIA,20,6,0,26
CONSULADOS,URUGUAY,76,23,1,100
CONSULADOS,VENEZUELA,9903,5539,76,15518
CORDOBA,AYAPEL,4178,2882,81,7141
CORDOBA,BUENAVISTA,4048,1541,61,5650
CORDOBA,CANALETE,2640,777,20,3437
CORDOBA,CERETE,11746,11179,256,23181
CORDOBA,CHIMA,2825,1091,27,3943
CORDOBA,CHINU,6434,6345,174,12953
CORDOBA,CIENAGA DE ORO,9377,5504,188,15069
CORDOBA,COTORRA (BONGO),2636,1387,59,4082
CORDOBA,LA APARTADA (FRONTERA),2537,1217,65,3819
CORDOBA,LORICA,17559,8386,266,26211
CORDOBA,LOS CORDOBAS,3695,1057,39,4791
CORDOBA,MOMIL,2830,1340,25,4195
CORDOBA,MONTELIBANO,10631,7643,340,18614
CORDOBA,MONTERIA,44207,47850,781,92838
CORDOBA,MOÃITOS,4230,1090,65,5385
CORDOBA,PLANETA RICA,8676,6244,246,15166
CORDOBA,PUEBLO NUEVO,4882,2428,92,7402
CORDOBA,PUERTO ESCONDIDO,4000,1170,60,5230
CORDOBA,PUERTO LIBERTADOR,7691,2439,179,10309
CORDOBA,PURISIMA,1972,1778,38,3788
CORDOBA,SAHAGUN,16501,9762,284,26547
CORDOBA,SAN ANDRES DE SOTAVENTO,7633,2826,134,10593
CORDOBA,SAN ANTERO,4352,2605,88,7045
CORDOBA,SAN BERNARDO DEL VIENTO,5799,1434,57,7290
CORDOBA,SAN CARLOS,2150,1511,36,3697
CORDOBA,SAN JOSE DE URE,2198,516,43,2757
CORDOBA,SAN PELAYO,7363,3601,141,11105
CORDOBA,TIERRALTA,12579,5452,311,18342
CORDOBA,TUCHIN,5273,2467,197,7937
CORDOBA,VALENCIA,4581,2089,91,6761
CUNDINAMARCA,AGUA DE DIOS,1723,2117,38,3878
CUNDINAMARCA,ALBAN,693,1086,33,1812
CUNDINAMARCA,ANAPOIMA,2008,2466,40,4514
CUNDINAMARCA,ANOLAIMA,1698,2461,46,4205
CUNDINAMARCA,APULO,1323,1315,35,2673
CUNDINAMARCA,ARBELAEZ,1496,2349,45,3890
CUNDINAMARCA,BELTRAN,321,325,6,652
CUNDINAMARCA,BITUIMA,454,396,8,858
CUNDINAMARCA,BOJACA,1241,1875,76,3192
CUNDINAMARCA,CABRERA,991,346,79,1416
CUNDINAMARCA,CACHIPAY,1686,1756,41,3483
CUNDINAMARCA,CAJICA,9016,10722,275,20013
CUNDINAMARCA,CAPARRAPI,1170,2076,74,3320
CUNDINAMARCA,CAQUEZA,2001,3393,109,5503
CUNDINAMARCA,CARMEN DE CARUPA,780,1287,41,2108
CUNDINAMARCA,CHAGUANI,740,721,19,1480
CUNDINAMARCA,CHIA,21717,21715,424,43856
CUNDINAMARCA,CHIPAQUE,892,1985,43,2920
CUNDINAMARCA,CHOACHI,1573,3042,70,4685
CUNDINAMARCA,CHOCONTA,2041,3578,110,5729
CUNDINAMARCA,COGUA,2684,3935,128,6747
CUNDINAMARCA,COTA,4585,5388,98,10071
CUNDINAMARCA,CUCUNUBA,728,1371,49,2148
CUNDINAMARCA,EL COLEGIO,3186,3938,82,7206
CUNDINAMARCA,EL PEÃON,521,809,17,1347
CUNDINAMARCA,EL ROSAL,2479,5218,171,7868
CUNDINAMARCA,FACATATIVA,18839,26978,1056,46873
CUNDINAMARCA,FOMEQUE,1126,2777,38,3941
CUNDINAMARCA,FOSCA,438,1565,11,2014
CUNDINAMARCA,FUNZA,13403,17147,534,31084
CUNDINAMARCA,FUQUENE,773,828,33,1634
CUNDINAMARCA,FUSAGASUGA,17890,23323,573,41786
CUNDINAMARCA,GACHALA,736,793,43,1572
CUNDINAMARCA,GACHANCIPA,1718,2816,113,4647
CUNDINAMARCA,GACHETA,1070,2036,55,3161
CUNDINAMARCA,GAMA,540,609,18,1167
CUNDINAMARCA,GIRARDOT,12251,20971,334,33556
CUNDINAMARCA,GRANADA,1022,1171,39,2232
CUNDINAMARCA,GUACHETA,1424,2003,103,3530
CUNDINAMARCA,GUADUAS,3388,4854,181,8423
CUNDINAMARCA,GUASCA,1555,2836,60,4451
CUNDINAMARCA,GUATAQUI,402,307,13,722
CUNDINAMARCA,GUATAVITA,811,1279,32,2122
CUNDINAMARCA,GUAYABAL DE SIQUIMA,750,770,28,1548
CUNDINAMARCA,GUAYABETAL,513,1470,36,2019
CUNDINAMARCA,GUTIERREZ,480,831,27,1338
CUNDINAMARCA,JERUSALEN,474,391,7,872
CUNDINAMARCA,JUNIN,694,1023,39,1756
CUNDINAMARCA,LA CALERA,4885,4267,114,9266
CUNDINAMARCA,LA MESA,4356,4291,123,8770
CUNDINAMARCA,LA PALMA,1714,1088,74,2876
CUNDINAMARCA,LA PEÃA,514,1498,30,2042
CUNDINAMARCA,LA VEGA,2408,2863,111,5382
CUNDINAMARCA,LENGUAZAQUE,1011,1532,77,2620
CUNDINAMARCA,MACHETA,762,1008,35,1805
CUNDINAMARCA,MADRID,10555,17404,641,28600
CUNDINAMARCA,MANTA,848,840,34,1722
CUNDINAMARCA,MEDINA,1042,1899,54,2995
CUNDINAMARCA,MOSQUERA,13047,16521,448,30016
CUNDINAMARCA,NARIÃO,353,388,4,745
CUNDINAMARCA,NEMOCON,1603,2758,90,4451
CUNDINAMARCA,NILO,1397,1107,18,2522
CUNDINAMARCA,NIMAIMA,540,750,24,1314
CUNDINAMARCA,NOCAIMA,1252,886,40,2178
CUNDINAMARCA,PACHO,3726,3959,143,7828
CUNDINAMARCA,PAIME,766,692,22,1480
CUNDINAMARCA,PANDI,741,638,23,1402
CUNDINAMARCA,PARATEBUENO (LA NAGUAYA),1227,1749,69,3045
CUNDINAMARCA,PASCA,1567,1176,64,2807
CUNDINAMARCA,PUERTO SALGAR,1421,2852,94,4367
CUNDINAMARCA,PULI,437,466,24,927
CUNDINAMARCA,QUEBRADANEGRA,480,1137,21,1638
CUNDINAMARCA,QUETAME,741,1551,53,2345
CUNDINAMARCA,QUIPILE,745,1302,26,2073
CUNDINAMARCA,RICAURTE,1688,2076,17,3781
CUNDINAMARCA,SAN ANTONIO DEL TEQUENDAMA,1704,1607,33,3344
CUNDINAMARCA,SAN BERNARDO,1286,1409,52,2747
CUNDINAMARCA,SAN CAYETANO,651,691,9,1351
CUNDINAMARCA,SAN FRANCISCO,1180,2099,32,3311
CUNDINAMARCA,SAN JUAN DE RIOSECO,1523,1853,41,3417
CUNDINAMARCA,SASAIMA,1137,2130,35,3302
CUNDINAMARCA,SESQUILE,1488,2266,109,3863
CUNDINAMARCA,SIBATE,4132,6222,179,10533
CUNDINAMARCA,SILVANIA,3045,3323,68,6436
CUNDINAMARCA,SIMIJACA,1179,2097,65,3341
CUNDINAMARCA,SOACHA,42449,46767,1464,90680
CUNDINAMARCA,SOPO,4579,4500,137,9216
CUNDINAMARCA,SUBACHOQUE,1838,4070,90,5998
CUNDINAMARCA,SUESCA,1956,2620,138,4714
CUNDINAMARCA,SUPATA,574,942,30,1546
CUNDINAMARCA,SUSA,1048,949,76,2073
CUNDINAMARCA,SUTATAUSA,563,996,35,1594
CUNDINAMARCA,TABIO,3249,3983,134,7366
CUNDINAMARCA,TAUSA,737,1886,63,2686
CUNDINAMARCA,TENA,1238,1028,23,2289
CUNDINAMARCA,TENJO,2903,3968,93,6964
CUNDINAMARCA,TIBACUY,778,681,20,1479
CUNDINAMARCA,TIBIRITA,667,357,9,1033
CUNDINAMARCA,TOCAIMA,2351,2249,60,4660
CUNDINAMARCA,TOCANCIPA,4971,6865,320,12156
CUNDINAMARCA,TOPAIPI,825,656,38,1519
CUNDINAMARCA,UBALA,1082,1541,69,2692
CUNDINAMARCA,UBAQUE,915,1197,45,2157
CUNDINAMARCA,UBATE,4922,7985,274,13181
CUNDINAMARCA,UNE,1296,1606,37,2939
CUNDINAMARCA,UTICA,616,1184,18,1818
CUNDINAMARCA,VENECIA,677,513,15,1205
CUNDINAMARCA,VERGARA,1147,1084,41,2272
CUNDINAMARCA,VIANI,726,673,28,1427
CUNDINAMARCA,VILLAGOMEZ,198,375,17,590
CUNDINAMARCA,VILLAPINZON,1661,4039,89,5789
CUNDINAMARCA,VILLETA,3165,5842,93,9100
CUNDINAMARCA,VIOTA,1899,2006,66,3971
CUNDINAMARCA,YACOPI,1339,1772,51,3162
CUNDINAMARCA,ZIPACON,962,1071,17,2050
CUNDINAMARCA,ZIPAQUIRA,20348,21680,807,42835
GUAINIA,BARRANCO MINAS,298,67,5,370
GUAINIA,CACAHUAL,17,7,1,25
GUAINIA,INIRIDA,2663,2436,50,5149
GUAINIA,LA GUADALUPE,0,0,0,0
GUAINIA,MAPIRIPANA,45,4,0,49
GUAINIA,MORICHAL (MORICHAL NUEVO),42,0,0,42
GUAINIA,PANA PANA (CAMPO ALEGRE),116,46,0,162
GUAINIA,PUERTO COLOMBIA,60,45,0,105
GUAINIA,SAN FELIPE,85,59,5,149
GUAVIARE,CALAMAR,1079,417,24,1520
GUAVIARE,EL RETORNO,2048,1410,125,3583
GUAVIARE,MIRAFLORES,848,142,11,1001
GUAVIARE,SAN JOSE DEL GUAVIARE,7157,7955,413,15525
HUILA,ACEVEDO,1432,4658,79,6169
HUILA,AGRADO,875,1849,29,2753
HUILA,AIPE,2491,2917,71,5479
HUILA,ALGECIRAS,2761,2306,92,5159
HUILA,ALTAMIRA,439,561,11,1011
HUILA,BARAYA,1206,1057,17,2280
HUILA,CAMPOALEGRE,3811,6134,173,10118
HUILA,COLOMBIA,952,1431,26,2409
HUILA,ELIAS,645,682,14,1341
HUILA,GARZON,6356,12101,287,18744
HUILA,GIGANTE,2668,4263,188,7119
HUILA,GUADALUPE,1331,3132,83,4546
HUILA,HOBO,1005,1250,42,2297
HUILA,IQUIRA,1110,1727,40,2877
HUILA,ISNOS,2041,5426,155,7622
HUILA,LA ARGENTINA (PLATA VIEJA),1291,1603,69,2963
HUILA,LA PLATA,4475,9191,205,13871
HUILA,NATAGA,604,1124,20,1748
HUILA,NEIVA,49083,58666,1066,108815
HUILA,OPORAPA,847,2246,45,3138
HUILA,PAICOL,604,1522,27,2153
HUILA,PALERMO,2901,4814,79,7794
HUILA,PALESTINA,1146,1876,64,3086
HUILA,PITAL,1016,2565,55,3636
HUILA,PITALITO,10660,19996,405,31061
HUILA,RIVERA,2919,3446,90,6455
HUILA,SALADOBLANCO,1420,1936,53,3409
HUILA,SAN AGUSTIN,2741,5652,144,8537
HUILA,SANTA MARIA,939,2318,47,3304
HUILA,SUAZA,1027,2183,56,3266
HUILA,TARQUI,1427,3015,59,4501
HUILA,TELLO,1899,2120,83,4102
HUILA,TERUEL,738,1799,36,2573
HUILA,TESALIA (CARNICERIAS),788,2559,60,3407
HUILA,TIMANA,1441,4471,65,5977
HUILA,VILLAVIEJA,1480,1086,44,2610
HUILA,YAGUARA,1137,1802,39,2978
LA GUAJIRA,ALBANIA,2333,1655,64,4052
LA GUAJIRA,BARRANCAS,4562,1806,73,6441
LA GUAJIRA,DIBULLA,3306,1309,68,4683
LA GUAJIRA,DISTRACCION,1587,892,31,2510
LA GUAJIRA,EL MOLINO,1644,836,21,2501
LA GUAJIRA,FONSECA,6402,2463,101,8966
LA GUAJIRA,HATONUEVO,2846,1304,59,4209
LA GUAJIRA,LA JAGUA DEL PILAR,861,320,15,1196
LA GUAJIRA,MAICAO,10766,9563,187,20516
LA GUAJIRA,MANAURE,1768,1418,44,3230
LA GUAJIRA,RIOHACHA,17613,10092,298,28003
LA GUAJIRA,SAN JUAN DEL CESAR,4484,4684,158,9326
LA GUAJIRA,URIBIA,1713,1658,44,3415
LA GUAJIRA,URUMITA,2042,1141,32,3215
LA GUAJIRA,VILLANUEVA,3490,2425,79,5994
MAGDALENA,ALGARROBO,1525,467,28,2020
MAGDALENA,ARACATACA,962,555,25,1542
MAGDALENA,ARIGUANI (EL DIFICIL),3393,2111,51,5555
MAGDALENA,CERRO DE SAN ANTONIO,2184,225,23,2432
MAGDALENA,CHIVOLO,2827,728,39,3594
MAGDALENA,CIENAGA,8629,8670,117,17416
MAGDALENA,CONCORDIA,2251,341,16,2608
MAGDALENA,EL BANCO,6883,5392,152,12427
MAGDALENA,EL PIÃON,2506,529,22,3057
MAGDALENA,EL RETEN,1932,800,27,2759
MAGDALENA,FUNDACION,4609,4308,97,9014
MAGDALENA,GUAMAL,2989,1643,36,4668
MAGDALENA,NUEVA GRANADA,1770,1205,18,2993
MAGDALENA,PEDRAZA,1340,552,14,1906
MAGDALENA,PIJIÃO DEL CARMEN,1557,902,24,2483
MAGDALENA,PIVIJAY,6313,933,84,7330
MAGDALENA,PLATO,6312,3303,98,9713
MAGDALENA,PUEBLOVIEJO,1957,1920,37,3914
MAGDALENA,REMOLINO,1716,200,15,1931
MAGDALENA,SABANAS DE SAN ANGEL,1090,728,17,1835
MAGDALENA,SALAMINA,738,557,10,1305
MAGDALENA,SAN SEBASTIAN DE BUENAVISTA,3903,1118,41,5062
MAGDALENA,SAN ZENON,2298,497,14,2809
MAGDALENA,SANTA ANA,2301,1913,37,4251
MAGDALENA,SANTA BARBARA DE PINTO,1737,383,21,2141
MAGDALENA,SANTA MARTA,49797,43163,767,93727
MAGDALENA,SITIONUEVO,1649,764,19,2432
MAGDALENA,TENERIFE,2469,438,39,2946
MAGDALENA,ZAPAYAN,2119,489,21,2629
MAGDALENA,ZONA BANANERA (SEVILLA),2307,1268,25,3600
META,ACACIAS,7978,21513,663,30154
META,BARRANCA DE UPIA,613,1104,34,1751
META,CABUYARO,718,1182,30,1930
META,CASTILLA LA NUEVA,1739,4350,149,6238
META,CUBARRAL,602,1385,30,2017
META,CUMARAL,2456,5099,115,7670
META,EL CALVARIO,354,310,11,675
META,EL CASTILLO,1247,774,34,2055
META,EL DORADO,570,777,13,1360
META,FUENTE DE ORO,1556,2153,75,3784
META,GRANADA,7007,12415,421,19843
META,GUAMAL,1316,4078,62,5456
META,LA MACARENA,2238,800,51,3089
META,LEJANIAS,1287,1636,92,3015
META,MAPIRIPAN,697,505,33,1235
META,MESETAS,1843,1126,46,3015
META,PUERTO CONCORDIA,1198,974,61,2233
META,PUERTO GAITAN,2813,5637,188,8638
META,PUERTO LLERAS,997,1251,41,2289
META,PUERTO LOPEZ,2564,6618,126,9308
META,PUERTO RICO,1443,1553,79,3075
META,RESTREPO,2464,3557,60,6081
META,SAN CARLOS DE GUAROA,1179,2394,59,3632
META,SAN JUAN DE ARAMA,1064,1162,48,2274
META,SAN JUANITO,309,263,8,580
META,SAN MARTIN DE LOS LLANOS,2162,5593,99,7854
META,URIBE,2036,140,14,2190
META,VILLAVICENCIO,56633,100830,1757,159220
META,VISTA HERMOSA,2593,2310,126,5029
NARIÑO,ALBAN (SAN JOSE),1244,1610,65,2919
NARIÑO,ALDANA,1298,1268,52,2618
NARIÑO,ANCUYA,1683,631,35,2349
NARIÑO,ARBOLEDA (BERRUECOS),1154,1236,67,2457
NARIÑO,BARBACOAS,3159,1063,63,4285
NARIÑO,BELEN,1418,934,32,2384
NARIÑO,BUESACO,2921,2914,109,5944
NARIÑO,CHACHAGUI,2377,1427,50,3854
NARIÑO,COLON (GENOVA),1573,1034,127,2734
NARIÑO,CONSACA,1969,1434,83,3486
NARIÑO,CONTADERO,1036,903,25,1964
NARIÑO,CORDOBA,2138,1301,53,3492
NARIÑO,CUASPUD (CARLOSAMA),1245,1382,37,2664
NARIÑO,CUMBAL,5421,3085,216,8722
NARIÑO,CUMBITARA,2119,299,25,2443
NARIÑO,EL CHARCO,4599,465,60,5124
NARIÑO,EL PEÃOL,2312,554,58,2924
NARIÑO,EL ROSARIO,2344,238,42,2624
NARIÑO,EL TABLON,2980,1557,109,4646
NARIÑO,EL TAMBO,3563,1476,108,5147
NARIÑO,FRANCISCO PIZARRO (SALAHONDA),1332,247,27,1606
NARIÑO,FUNES,1575,737,31,2343
NARIÑO,GUACHUCAL,2511,1938,78,4527
NARIÑO,GUAITARILLA,2255,800,47,3102
NARIÑO,GUALMATAN,1404,932,32,2368
NARIÑO,ILES,1430,857,45,2332
NARIÑO,IMUES,1156,912,28,2096
NARIÑO,IPIALES,15864,15842,503,32209
NARIÑO,LA CRUZ,2846,2652,87,5585
NARIÑO,LA FLORIDA,2292,848,39,3179
NARIÑO,LA LLANADA,996,400,58,1454
NARIÑO,LA TOLA,1710,234,23,1967
NARIÑO,LA UNION,3200,4247,164,7611
NARIÑO,LEIVA,2605,277,44,2926
NARIÑO,LINARES,3047,452,64,3563
NARIÑO,LOS ANDES (SOTOMAYOR),2426,723,60,3209
NARIÑO,MAGUI (PAYAN),2129,157,34,2320
NARIÑO,MALLAMA (PIEDRANCHA),1154,675,38,1867
NARIÑO,MOSQUERA,1975,224,22,2221
NARIÑO,NARIÃO,988,649,21,1658
NARIÑO,OLAYA HERRERA,2632,572,36,3240
NARIÑO,OSPINA,1102,637,26,1765
NARIÑO,PASTO,70354,41981,1505,113840
NARIÑO,POLICARPA,3690,461,51,4202
NARIÑO,POTOSI,1590,1809,63,3462
NARIÑO,PROVIDENCIA,1586,228,26,1840
NARIÑO,PUERRES,2191,997,70,3258
NARIÑO,PUPIALES,2820,3010,140,5970
NARIÑO,RICAURTE,1947,974,48,2969
NARIÑO,ROBERTO PAYAN (SAN JOSE),2135,198,22,2355
NARIÑO,SAMANIEGO,7072,1359,166,8597
NARIÑO,SAN BERNARDO,1892,1172,50,3114
NARIÑO,SAN LORENZO,2812,1711,158,4681
NARIÑO,SAN PABLO,2353,1221,93,3667
NARIÑO,SAN PEDRO DE CARTAGO,1058,989,52,2099
NARIÑO,SANDONA,4208,2346,112,6666
NARIÑO,SANTA BARBARA (ISCUANDE),2229,206,24,2459
NARIÑO,SANTACRUZ (GUACHAVES),1301,513,39,1853
NARIÑO,SAPUYES,1089,715,32,1836
NARIÑO,TAMINANGO,3792,1028,94,4914
NARIÑO,TANGUA,1659,1467,46,3172
NARIÑO,TUMACO,23534,9520,709,33763
NARIÑO,TUQUERRES,6384,3521,268,10173
NARIÑO,YACUANQUER,2169,1034,88,3291
NORTE DE SANTANDER,ABREGO,2095,4149,77,6321
NORTE DE SANTANDER,ARBOLEDAS,907,2078,58,3043
NORTE DE SANTANDER,BOCHALEMA,1080,1786,50,2916
NORTE DE SANTANDER,BUCARASICA,413,985,70,1468
NORTE DE SANTANDER,CACHIRA,531,2060,28,2619
NORTE DE SANTANDER,CACOTA,413,432,24,869
NORTE DE SANTANDER,CHINACOTA,1983,3351,90,5424
NORTE DE SANTANDER,CHITAGA,1056,1729,78,2863
NORTE DE SANTANDER,CONVENCION,2101,1411,137,3649
NORTE DE SANTANDER,CUCUTA,83572,157742,3088,244402
NORTE DE SANTANDER,CUCUTILLA,938,1850,72,2860
NORTE DE SANTANDER,DURANIA,1003,885,32,1920
NORTE DE SANTANDER,EL CARMEN,1515,1388,118,3021
NORTE DE SANTANDER,EL TARRA,2827,262,92,3181
NORTE DE SANTANDER,EL ZULIA,2770,5024,181,7975
NORTE DE SANTANDER,GRAMALOTE,632,1253,38,1923
NORTE DE SANTANDER,HACARI,1562,184,59,1805
NORTE DE SANTANDER,HERRAN,377,769,28,1174
NORTE DE SANTANDER,LA ESPERANZA,1021,1941,55,3017
NORTE DE SANTANDER,LA PLAYA,734,769,39,1542
NORTE DE SANTANDER,LABATECA,877,782,32,1691
NORTE DE SANTANDER,LOS PATIOS,7986,20494,293,28773
NORTE DE SANTANDER,LOURDES,317,904,53,1274
NORTE DE SANTANDER,MUTISCUA,499,605,21,1125
NORTE DE SANTANDER,OCAÃA,10753,16720,378,27851
NORTE DE SANTANDER,PAMPLONA,6506,12079,293,18878
NORTE DE SANTANDER,PAMPLONITA,577,1178,46,1801
NORTE DE SANTANDER,PUERTO SANTANDER,591,1607,28,2226
NORTE DE SANTANDER,RAGONVALIA,422,1266,23,1711
NORTE DE SANTANDER,SALAZAR,974,2029,106,3109
NORTE DE SANTANDER,SAN CALIXTO,2393,121,68,2582
NORTE DE SANTANDER,SAN CAYETANO,694,1509,33,2236
NORTE DE SANTANDER,SANTIAGO,642,779,30,1451
NORTE DE SANTANDER,SARDINATA,1991,3725,119,5835
NORTE DE SANTANDER,SILOS,259,1100,18,1377
NORTE DE SANTANDER,TEORAMA,2429,380,99,2908
NORTE DE SANTANDER,TIBU,5847,3008,228,9083
NORTE DE SANTANDER,TOLEDO,1311,2803,135,4249
NORTE DE SANTANDER,VILLA CARO,297,920,23,1240
NORTE DE SANTANDER,VILLA DEL ROSARIO,6360,20126,275,26761
PUTUMAYO,COLON,1072,804,19,1895
PUTUMAYO,MOCOA,7718,5105,159,12982
PUTUMAYO,ORITO,6165,1820,155,8140
PUTUMAYO,PUERTO ASIS,6267,4539,207,11013
PUTUMAYO,PUERTO CAICEDO,1947,802,79,2828
PUTUMAYO,PUERTO GUZMAN,2176,832,57,3065
PUTUMAYO,PUERTO LEGUIZAMO,2031,1695,39,3765
PUTUMAYO,SAN FRANCISCO,1069,849,45,1963
PUTUMAYO,SAN MIGUEL (LA DORADA),2816,559,56,3431
PUTUMAYO,SANTIAGO,1359,881,48,2288
PUTUMAYO,SIBUNDOY,2499,1783,77,4359
PUTUMAYO,VALLE DEL GUAMUEZ (LA HORMIGA),6655,1079,105,7839
PUTUMAYO,VILLAGARZON,2869,2757,114,5740
QUINDIO,ARMENIA,43835,59049,1205,104089
QUINDIO,BUENAVISTA,441,564,17,1022
QUINDIO,CALARCA,8767,14557,377,23701
QUINDIO,CIRCASIA,3343,5837,131,9311
QUINDIO,CORDOBA,872,1028,35,1935
QUINDIO,FILANDIA,1522,2627,68,4217
QUINDIO,GENOVA,987,1739,55,2781
QUINDIO,LA TEBAIDA,4032,6822,204,11058
QUINDIO,MONTENEGRO,3398,8140,227,11765
QUINDIO,PIJAO,815,1523,34,2372
QUINDIO,QUIMBAYA,4528,7156,154,11838
QUINDIO,SALENTO,853,1666,32,2551
RISARALDA,APIA,1265,2404,84,3753
RISARALDA,BALBOA,891,1074,44,2009
RISARALDA,BELEN DE UMBRIA,2639,4278,143,7060
RISARALDA,DOSQUEBRADAS,28055,37995,1044,67094
RISARALDA,GUATICA,1240,2443,67,3750
RISARALDA,LA CELIA,903,1462,59,2424
RISARALDA,LA VIRGINIA,4852,7229,210,12291
RISARALDA,MARSELLA,2067,3350,97,5514
RISARALDA,MISTRATO,1926,1716,65,3707
RISARALDA,PEREIRA,75063,87598,2278,164939
RISARALDA,PUEBLO RICO,1720,1008,47,2775
RISARALDA,QUINCHIA,4144,3734,259,8137
RISARALDA,SANTA ROSA DE CABAL,9970,14826,518,25314
RISARALDA,SANTUARIO,1473,2113,119,3705
SAN ANDRES,PROVIDENCIA,974,216,4,1194
SAN ANDRES,SAN ANDRES,4301,4097,32,8430
SANTANDER,AGUADA,165,182,6,353
SANTANDER,ALBANIA,656,508,15,1179
SANTANDER,ARATOCA,1328,1251,51,2630
SANTANDER,BARBOSA,4413,4552,162,9127
SANTANDER,BARICHARA,1452,1085,51,2588
SANTANDER,BARRANCABERMEJA,38260,37440,1153,76853
SANTANDER,BETULIA,620,833,39,1492
SANTANDER,BOLIVAR,1400,1271,98,2769
SANTANDER,BUCARAMANGA,100143,122985,1982,225110
SANTANDER,CABRERA,446,232,10,688
SANTANDER,CALIFORNIA,152,532,19,703
SANTANDER,CAPITANEJO,672,1103,32,1807
SANTANDER,CARCASI,509,1058,61,1628
SANTANDER,CEPITA,584,318,25,927
SANTANDER,CERRITO,949,1109,82,2140
SANTANDER,CHARALA,2148,1353,53,3554
SANTANDER,CHARTA,372,941,18,1331
SANTANDER,CHIMA,558,299,31,888
SANTANDER,CHIPATA,687,273,12,972
SANTANDER,CIMITARRA,3718,5480,271,9469
SANTANDER,CONCEPCION,642,1015,62,1719
SANTANDER,CONFINES,321,524,14,859
SANTANDER,CONTRATACION,762,554,30,1346
SANTANDER,COROMORO,795,691,67,1553
SANTANDER,CURITI,1526,1741,76,3343
SANTANDER,EL CARMEN,1138,3114,162,4414
SANTANDER,EL GUACAMAYO,539,234,23,796
SANTANDER,EL PEÃON,620,631,45,1296
SANTANDER,EL PLAYON,1157,3041,104,4302
SANTANDER,ENCINO,405,244,26,675
SANTANDER,ENCISO,595,702,30,1327
SANTANDER,FLORIAN,1115,550,22,1687
SANTANDER,FLORIDABLANCA,36189,50640,870,87699
SANTANDER,GALAN,434,603,31,1068
SANTANDER,GAMBITA,603,497,19,1119
SANTANDER,GIRON,17099,28052,549,45700
SANTANDER,GUACA,766,1215,38,2019
SANTANDER,GUADALUPE,607,908,30,1545
SANTANDER,GUAPOTA,381,357,27,765
SANTANDER,GUAVATA,808,495,28,1331
SANTANDER,GUEPSA,885,548,20,1453
SANTANDER,HATO,464,310,19,793
SANTANDER,JESUS MARIA,645,375,19,1039
SANTANDER,JORDAN,194,191,3,388
SANTANDER,LA BELLEZA,741,1464,28,2233
SANTANDER,LA PAZ,681,490,29,1200
SANTANDER,LANDAZURI,1484,1336,173,2993
SANTANDER,LEBRIJA,3857,8738,175,12770
SANTANDER,LOS SANTOS,1643,2265,166,4074
SANTANDER,MACARAVITA,456,347,21,824
SANTANDER,MALAGA,2538,4086,178,6802
SANTANDER,MATANZA,866,1334,39,2239
SANTANDER,MOGOTES,1165,1501,128,2794
SANTANDER,MOLAGAVITA,531,830,38,1399
SANTANDER,OCAMONTE,1129,489,35,1653
SANTANDER,OIBA,1543,1931,79,3553
SANTANDER,ONZAGA,634,554,41,1229
SANTANDER,PALMAR,397,183,6,586
SANTANDER,PALMAS DEL SOCORRO,526,456,20,1002
SANTANDER,PARAMO,791,754,33,1578
SANTANDER,PIEDECUESTA,19145,28817,739,48701
SANTANDER,PINCHOTE,742,577,25,1344
SANTANDER,PUENTE NACIONAL,2492,1857,72,4421
SANTANDER,PUERTO PARRA,487,1026,17,1530
SANTANDER,PUERTO WILCHES,4098,4317,162,8577
SANTANDER,RIONEGRO,2675,5347,179,8201
SANTANDER,SABANA DE TORRES,2386,5347,124,7857
SANTANDER,SAN ANDRES,1642,1312,79,3033
SANTANDER,SAN BENITO,584,279,8,871
SANTANDER,SAN GIL,8574,8416,257,17247
SANTANDER,SAN JOAQUIN,429,264,25,718
SANTANDER,SAN JOSE DE MIRANDA,578,1187,25,1790
SANTANDER,SAN MIGUEL,423,356,24,803
SANTANDER,SAN VICENTE DE CHUCURI,3604,5237,252,9093
SANTANDER,SANTA BARBARA,255,453,15,723
SANTANDER,SANTA HELENA DEL OPON,396,633,65,1094
SANTANDER,SIMACOTA,1237,970,66,2273
SANTANDER,SOCORRO,4348,5049,123,9520
SANTANDER,SUAITA,1395,1189,65,2649
SANTANDER,SUCRE,698,1104,28,1830
SANTANDER,SURATA,478,805,40,1323
SANTANDER,TONA,808,1149,66,2023
SANTANDER,VALLE DE SAN JOSE,935,904,45,1884
SANTANDER,VELEZ,3254,2742,160,6156
SANTANDER,VETAS,92,476,10,578
SANTANDER,VILLANUEVA,912,1427,34,2373
SANTANDER,ZAPATOCA,984,1563,51,2598
SUCRE,BUENAVISTA,2187,993,22,3202
SUCRE,CAIMITO,2126,623,24,2773
SUCRE,CHALAN,869,466,19,1354
SUCRE,COLOSO (RICAURTE),1628,693,26,2347
SUCRE,COROZAL,10907,6973,206,18086
SUCRE,COVEÃAS,1918,1915,41,3874
SUCRE,EL ROBLE,2238,633,22,2893
SUCRE,GALERAS (NUEVA GRANADA),2181,3039,51,5271
SUCRE,GUARANDA,1811,1701,48,3560
SUCRE,LA UNION,2329,599,18,2946
SUCRE,LOS PALMITOS,5779,1751,66,7596
SUCRE,MAJAGUAL,3935,2857,52,6844
SUCRE,MORROA,3322,1753,101,5176
SUCRE,OVEJAS,5328,2019,58,7405
SUCRE,PALMITO,2323,1011,29,3363
SUCRE,SAMPUES,6816,4596,170,11582
SUCRE,SAN BENITO ABAD,3460,1917,46,5423
SUCRE,SAN JUAN DE BETULIA (BETULIA),3185,1282,39,4506
SUCRE,SAN MARCOS,7058,4036,165,11259
SUCRE,SAN ONOFRE,7973,2247,121,10341
SUCRE,SAN PEDRO,3759,2036,38,5833
SUCRE,SINCE,5470,3493,112,9075
SUCRE,SINCELEJO,37461,31435,771,69667
SUCRE,SUCRE,3100,2459,52,5611
SUCRE,TOLU,5427,2300,89,7816
SUCRE,TOLUVIEJO,5227,2060,63,7350
TOLIMA,ALPUJARRA,452,1005,46,1503
TOLIMA,ALVARADO,1312,1415,36,2763
TOLIMA,AMBALEMA,1216,1126,47,2389
TOLIMA,ANZOATEGUI,693,1576,42,2311
TOLIMA,ARMERO (GUAYABAL),1794,1676,68,3538
TOLIMA,ATACO,1658,3451,68,5177
TOLIMA,CAJAMARCA,1823,4084,85,5992
TOLIMA,CARMEN DE APICALA,1218,2242,34,3494
TOLIMA,CASABIANCA,922,953,22,1897
TOLIMA,CHAPARRAL,5476,6694,172,12342
TOLIMA,COELLO,1488,1157,34,2679
TOLIMA,COYAIMA,3404,2081,81,5566
TOLIMA,CUNDAY,1075,1516,31,2622
TOLIMA,DOLORES,1109,1563,52,2724
TOLIMA,ESPINAL,8388,14623,324,23335
TOLIMA,FALAN,1147,995,52,2194
TOLIMA,FLANDES,2373,4194,88,6655
TOLIMA,FRESNO,2741,5542,183,8466
TOLIMA,GUAMO,3042,5783,114,8939
TOLIMA,HERVEO,724,1128,40,1892
TOLIMA,HONDA,3549,4788,150,8487
TOLIMA,IBAGUE,70780,108879,2184,181843
TOLIMA,ICONONZO,1498,1335,49,2882
TOLIMA,LERIDA,2748,2812,77,5637
TOLIMA,LIBANO,5158,5238,226,10622
TOLIMA,MARIQUITA,4570,6277,217,11064
TOLIMA,MELGAR,3102,7663,130,10895
TOLIMA,MURILLO,409,690,56,1155
TOLIMA,NATAGAIMA,2970,2331,78,5379
TOLIMA,ORTEGA,3247,4872,227,8346
TOLIMA,PALOCABILDO,1003,1412,49,2464
TOLIMA,PIEDRAS,974,959,25,1958
TOLIMA,PLANADAS,2818,3081,198,6097
TOLIMA,PRADO,1121,1799,43,2963
TOLIMA,PURIFICACION,4045,4139,105,8289
TOLIMA,RIOBLANCO,2209,2317,119,4645
TOLIMA,RONCESVALLES,768,728,48,1544
TOLIMA,ROVIRA,1776,4287,152,6215
TOLIMA,SALDAÃA,1463,2954,53,4470
TOLIMA,SAN ANTONIO,1097,2770,94,3961
TOLIMA,SAN LUIS,1638,2595,57,4290
TOLIMA,SANTA ISABEL,485,1256,31,1772
TOLIMA,SUAREZ,700,1095,15,1810
TOLIMA,VALLE DE SAN JUAN,673,789,26,1488
TOLIMA,VENADILLO,1929,2478,52,4459
TOLIMA,VILLAHERMOSA,605,1732,39,2376
TOLIMA,VILLARRICA,671,1070,42,1783
VALLE,ALCALA,1804,1886,69,3759
VALLE,ANDALUCIA,3505,3219,101,6825
VALLE,ANSERMANUEVO,1667,3609,80,5356
VALLE,ARGELIA,923,983,30,1936
VALLE,BOLIVAR,2065,2759,75,4899
VALLE,BUENAVENTURA,42565,17670,1525,61760
VALLE,BUGA,20956,20572,551,42079
VALLE,BUGALAGRANDE,3977,2934,136,7047
VALLE,CAICEDONIA,3886,6106,186,10178
VALLE,CALI,319949,269502,4496,593947
VALLE,CALIMA (DARIEN),2238,2349,77,4664
VALLE,CANDELARIA,10898,12525,440,23863
VALLE,CARTAGO,14845,24101,554,39500
VALLE,DAGUA,4666,5858,150,10674
VALLE,EL AGUILA,871,1949,56,2876
VALLE,EL CAIRO,932,919,32,1883
VALLE,EL CERRITO,9380,8732,263,18375
VALLE,EL DOVIO,972,1987,51,3010
VALLE,FLORIDA,10354,7906,347,18607
VALLE,GINEBRA,3182,3263,99,6544
VALLE,GUACARI,5786,4555,184,10525
VALLE,JAMUNDI,18060,15665,518,34243
VALLE,LA CUMBRE,2037,2022,44,4103
VALLE,LA UNION,2792,7386,170,10348
VALLE,LA VICTORIA,1930,2234,55,4219
VALLE,OBANDO,1579,1970,81,3630
VALLE,PALMIRA,54278,45431,1162,100871
VALLE,PRADERA,7574,7263,258,15095
VALLE,RESTREPO,1777,2574,58,4409
VALLE,RIOFRIO,2103,3065,98,5266
VALLE,ROLDANILLO,4631,6372,115,11118
VALLE,SAN PEDRO,2708,2689,75,5472
VALLE,SEVILLA,6589,6231,335,13155
VALLE,TORO,1383,2422,77,3882
VALLE,TRUJILLO,1960,3296,85,5341
VALLE,TULUA,27738,32877,1001,61616
VALLE,ULLOA,909,712,28,1649
VALLE,VERSALLES,963,1650,38,2651
VALLE,VIJES,1812,1554,35,3401
VALLE,YOTOCO,2358,2608,61,5027
VALLE,YUMBO,18095,16252,470,34817
VALLE,ZARZAL,6632,6580,263,13475
VAUPES,BUENOS AIRES (PACOA),170,16,3,189
VAUPES,CARURU,382,76,7,465
VAUPES,MITU,2705,872,30,3607
VAUPES,MORICHAL (PAPUNAGUA),18,1,0,19
VAUPES,TARAIRA,243,65,1,309
VAUPES,YAVARATE,278,37,0,315
VICHADA,CUMARIBO,2717,952,52,3721
VICHADA,LA PRIMAVERA,661,1787,33,2481
VICHADA,PUERTO CARREÃO,2185,2549,62,4796
VICHADA,SANTA ROSALIA,576,689,13,1278
